20 20
6 6 6 6 6 6 6 6 6 6 6 6 6 6 6 6 6 6 6 6
6 6 6 6 6 6 6 6 6 6 6 6 6 6 6 6 6 6 6 6
6 6 6 6 1 5 5 9 5 5 8 5 5 9 5 5 3 6 6 6
6 6 6 1 2 6 6 6 6 6 6 6 6 6 6 6 4 6 6 6
6 6 1 2 6 6 6 6 6 6 6 6 6 6 6 1 2 6 6 6
6 6 4 6 6 6 6 6 6 6 6 6 6 6 1 2 6 6 6 6
6 6 9 6 6 6 6 6 6 6 6 6 6 6 4 6 6 6 6 6
6 6 4 6 6 6 6 6 6 6 6 6 6 6 8 6 6 6 6 6
6 6 4 6 6 6 6 6 6 6 6 6 6 6 9 6 6 6 6 6
6 6 4 6 6 6 6 6 6 6 6 6 6 6 4 6 6 6 6 6
6 6 7 6 6 6 6 6 6 6 6 6 6 6 0 5 5 3 6 6
6 6 4 6 6 6 6 6 6 6 6 6 6 6 6 6 6 4 6 6
6 6 4 6 6 6 6 6 6 6 6 6 6 6 6 6 6 4 6 6
6 6 9 6 6 6 6 6 6 6 6 6 6 6 6 6 6 8 6 6
6 6 4 6 6 6 6 6 6 6 6 6 6 6 6 6 6 4 6 6
6 6 0 3 6 6 6 6 6 6 6 6 6 6 6 6 6 4 6 6
6 6 6 0 3 6 6 6 6 6 6 6 6 6 6 6 6 9 6 6
6 6 6 6 0 5 5 9 5 5 8 5 5 9 5 5 5 2 6 6
6 6 6 6 6 6 6 6 6 6 6 6 6 6 6 6 6 6 6 6
6 6 6 6 6 6 6 6 6 6 6 6 6 6 6 6 6 6 6 6
