8 8
6 6 6 6 6 6 6 6
6 1 5 5 5 5 3 6
6 4 6 6 6 6 4 6
6 4 6 6 6 6 4 6
6 4 6 6 6 6 4 6
6 4 6 6 6 6 4 6
6 0 5 5 5 5 2 6
6 6 6 6 6 6 6 6