21 19
6 6 6 6 6 6 6 6 6 6 6 6 6 6 6 6 6 6 6
6 6 6 6 6 6 6 6 6 6 6 6 6 6 6 6 6 6 6
6 6 6 6 6 6 6 6 6 6 6 6 6 6 6 6 6 6 6
6 6 6 1 7 5 5 5 5 8 5 5 9 5 5 3 6 6 6
6 6 1 2 6 6 6 6 6 6 6 6 6 6 6 4 6 6 6
6 1 2 6 6 6 6 6 6 6 6 6 6 6 1 2 6 6 6
6 4 6 6 6 6 6 6 6 6 6 6 6 1 2 6 6 6 6
6 4 6 6 6 6 6 6 6 6 6 6 6 4 6 6 6 6 6
6 4 6 6 6 6 6 6 6 6 6 6 6 4 6 6 6 6 6
6 4 6 6 6 6 6 6 6 6 6 6 6 4 6 6 6 6 6
6 4 6 6 6 6 6 6 6 6 6 6 6 4 6 6 6 6 6
6 4 6 6 6 6 6 6 6 6 6 6 6 0 9 5 3 6 6
6 4 6 6 6 6 6 6 6 6 6 6 6 6 6 6 4 6 6
6 4 6 6 6 6 6 6 6 6 6 6 6 6 6 6 4 6 6
6 4 6 6 6 6 6 6 6 6 6 6 6 6 6 6 4 6 6
6 4 6 6 6 6 6 6 6 6 6 6 6 6 6 6 4 6 6
6 0 3 6 6 6 6 6 6 6 6 6 6 6 6 6 4 6 6
6 6 0 3 6 6 6 6 6 6 6 6 6 6 6 6 4 6 6
6 6 6 0 5 5 9 5 5 5 5 5 9 5 5 5 2 6 6
6 6 6 6 6 6 6 6 6 6 6 6 6 6 6 6 6 6 6
6 6 6 6 6 6 6 6 6 6 6 6 6 6 6 6 6 6 6
